╔══════════════════════════════════════════════════════════════════════════════════════╗
║                                                                                      ║
║                             ┌─────────────────────────┐                              ║
║      ┌──────────┐           |   ╔──┐                  |           ┌──────────┐       ║
║      | ░░░░░░░░ |           |   ║  |                  |           | ░░░░░░░░ |       ║
║      | ░░░░░░░░ |           |   ╚──┘                  |           | ░░░░░░░░ |       ║
║      |▒▒▒▒▒▒▒▒▒▒|           └─────────────────────────┘           |▒▒▒▒▒▒▒▒▒▒|       ║
║      |▒▒▒▒▒▒▒▒▒▒|                       ┌┐░░░░░░░░┌┐              |▒▒▒▒▒▒▒▒▒▒|       ║
║      |▒▒▒▒▒▒▒▒▒▒|                       ||░░░░░░░░||              |▒▒▒▒▒▒▒▒▒▒|       ║
║      |▒▒▒▒▒▒▒▒▒▒|                       └──────────┘              |▒▒▒▒▒▒▒▒▒▒|       ║
║      |▒▒▒▒▒▒▒▒▒▒|                                                 |▒▒▒▒▒▒▒▒▒▒|       ║
║      |▒▒▒▒▒▒▒▒▒▒|                                                 |▒▒▒▒▒▒▒▒▒▒|       ║
║      |▒▒▒▒▒▒▒▒▒▒|                                                 |▒▒▒▒▒▒▒▒▒▒|       ║
║      |▒▒▒▒▒▒▒▒▒▒|                                                 |▒▒▒▒▒▒▒▒▒▒|       ║
║      └──────────┘                                                 └──────────┘       ║
║                                                                                      ║
║                                                                                      ║
║                                                                                      ║
║                                                                                      ║
║                                                                                      ║
║      ┌──────────┐                                                                    ║
║      | ░░░░░░░░ |                                                                    ║
║      | ░░░░░░░░ |                                                                    ║
║      |▒▒▒▒▒▒▒▒▒▒|                                                                    ║
║      |▒▒▒▒▒▒▒▒▒▒|                                                                    ║
║      |▒▒▒▒▒▒▒▒▒▒|                                                                    ║
║      |▒▒▒▒▒▒▒▒▒▒|
║      |▒▒▒▒▒▒▒▒▒▒|
║      |▒▒▒▒▒▒▒▒▒▒|
║      |▒▒▒▒▒▒▒▒▒▒|
║      |▒▒▒▒▒▒▒▒▒▒|
║      └──────────┘
║                                                                                      ║
║                                                                                      ║
║                                                                                      ║
║                                                                                      ║
║                                                                                      ║
║                                                                                      ║
║                                                                                      ║
╚══════════════════════════════════════════════════════════════════════════════════════╝