.                                                                                      .
                                                                                      






║######################################################################################║
║######################################################################################║
║══════════════════════════════════════════════════════════════════════════════════════║
║//////////////////////////////////////////////////////////////////////////////////////║
║//////////////////////////////////////////////////////////////////////////////////////║
║//////////////////////////////////////////////////////////////////////////////////////║
║//////////////////////////////////////////////////////////////////////////////////////║
║//////////////////////////////////////////////////////////////////////////////////////║
║//////////////////////////////////////////////////////////////////////////////////////║
║//////////////////////////////////////////////////////////////////////////////////////║
║//////////////////////////////////////////////////////////////////////////////////////║
║══════════════════════════════════════════════════════════════════════════════════════║
║                                                                                      ║
║                                                                                      ║
║                                                                                      ║
║                                                                                      ║
║                                                                                туалет║
║                                                                                 ->   ║






║                                                                                      ║
║                                                                                      ║
║                                                                                      ║
║                                                                                      ║
║                                                                                      ║
║                                                                                      ║
║                                                                                      ║
╚════             ═════════════════════════════════════════════════════════════════════╝