.                                                                                      .
                                                                                      






║######################################################################################║
║######################################################################################║
║══════════════════════════════════════════════════════════════════════════════════════║
║//////////////////////////////////////////////////////////////////////////////////////║
║//////////////////////////////////////////////////////////////////////////////////////║
║//////////////////////////////////////////////////////////////////////////////////////║
║//////////////////////////////////////////////////////////////////////////////////////║
║//////////////////////////////////////////////////////////////////////////////////////║
║//////////////////////////////////////////////////////////////////////////////////////║
║//////////////////////////////////////////////////////////////////////////////////////║
║//////////////////////////////////////////////////////////////////////////////////////║
║══════════════════════════════════════════════════════════════════════════════════════║
║                                                                                      ║
║                                                                                      ║
║                                                                                      ║
║                                                                                      ║
║                                                                                    WC║
║                                                                                    ->║






║                                                                                      ║
║                                                                                      ║
║                                                                                      ║
║                                                                                      ║
║                                                                                      ║
║                                                                                      ║
║                                                                                      ║
╚════             ═════════════════════════════════════════════════════════════════════╝