╔══════════════════════════════════════════════════════════════════════════════════════╗
║                                                                                      ║
║                             ┌─────────────────────────┐                              ║
║      ┌──────────┐           |   ╔──┐                  |           ┌──────────┐       ║
║      | ░░░░░░░░ |           |   ║  |                  |           | ░░░░░░░░ |       ║
║      | ░░░░░░░░ |           |   ╚──┘                  |           | ░░░░░░░░ |       ║
║      |▒▒▒▒▒▒▒▒▒▒|           └─────────────────────────┘           |▒▒▒▒▒▒▒▒▒▒|       ║
║      |▒▒▒▒▒▒▒▒▒▒|                       ┌┐░░░░░░░░┌┐              |▒▒▒▒▒▒▒▒▒▒|       ║
║      |▒▒▒▒▒▒▒▒▒▒|                       ||░░░░░░░░||              |▒▒▒▒▒▒▒▒▒▒|       ║
║      |▒▒▒▒▒▒▒▒▒▒|                       └──────────┘              |▒▒▒▒▒▒▒▒▒▒|       ║
║      |▒▒▒▒▒▒▒▒▒▒|                                                 |▒▒▒▒▒▒▒▒▒▒|       ║
║      |▒▒▒▒▒▒▒▒▒▒|                                                 |▒▒▒▒▒▒▒▒▒▒|       ║
║      |▒▒▒▒▒▒▒▒▒▒|                                                 |▒▒▒▒▒▒▒▒▒▒|       ║
║      |▒▒▒▒▒▒▒▒▒▒|                                                 |▒▒▒▒▒▒▒▒▒▒|       ║
║      └──────────┘                                                 └──────────┘       ║
║                                                                                      ║
║                                                                                      ║
║                                                                                      ║
║                                                                                      ║
║                                                                                      ║
║      ┌──────────┐                                                 ┌──────────┐       ║
║      | ░░░░░░░░ |                                                 | ░░░░░░░░ |       ║
║      | ░░░░░░░░ |                                                 | ░░░░░░░░ |       ║
║      |▒▒▒▒▒▒▒▒▒▒|                                                 |▒▒▒▒▒▒▒▒▒▒|       ║
║      |▒▒▒▒▒▒▒▒▒▒|                                                 |▒▒▒▒▒▒▒▒▒▒|       ║
║      |▒▒▒▒▒▒▒▒▒▒|                                                 |▒▒▒▒▒▒▒▒▒▒|       ║
║      |▒▒▒▒▒▒▒▒▒▒|                                                 |▒▒▒▒▒▒▒▒▒▒|       ║
║      |▒▒▒▒▒▒▒▒▒▒|                                                 |▒▒▒▒▒▒▒▒▒▒|       ║
║      |▒▒▒▒▒▒▒▒▒▒|                                                 |▒▒▒▒▒▒▒▒▒▒|       ║
║      |▒▒▒▒▒▒▒▒▒▒|                                                 |▒▒▒▒▒▒▒▒▒▒|       ║
║      |▒▒▒▒▒▒▒▒▒▒|                                                 |▒▒▒▒▒▒▒▒▒▒|       ║
║      └──────────┘                                                 └──────────┘       ║
║                                                                                      ║
║                                                                                      ║
║                                                                                      ║
║                                                                                      ║
║                                                                                      ║
║                                                                                      ║
║                                                                                      ║
╚════════════════════════           ═══════════════════════════════════════════════════╝