╔══════════════════════════════════════════════════════════════════════════════════════╗
║                           ______________________________________                     ║
║                          /                                     /                     ║
║                          |                                     |                     ║
║                          |                                     |                     ║
║                          |                                     |                     ║
║                          |                                     |                     ║
║         (¯¯¯¯¯¯¯¯¯¯¯¯¯¯¯¯¯¯¯¯¯¯¯¯¯¯¯¯¯¯¯¯¯¯¯¯¯¯¯¯¯¯¯¯¯¯¯¯¯¯¯¯¯¯¯¯¯¯¯¯¯¯¯¯¯¯¯¯¯¯)_____║
║          (                                                                    )      ║
║           (                                                                  )       ║
║            (                                                                )        ║
║             (                                                              )         ║
║             *                                                              *         ║
║              (                                                            )          ║
║               (                                                          )           ║
║                (                                                        )            ║
║                 (                                                      )             ║
║                  (                                                    )              ║
║                   (                                                  )               ║
║                   (                                                  )               ║
║                                                                                      ║
║                                                                                      ║
║                                                                                      ║
║                                                                                      ║
║                                                                                      ║
║                                                                                      ║
                                                                                        
                                                                                        
                                                                                        
                                                                                        
                                                                                        
                                                                                        
║                                                                                      
║                                                                                      ║
║                                                                                      ║
║                                                                                      ║
║                                                                                      ║
║                                                                                      ║
║                                                                                      ║
╚═══════            ═══════════════════════════════════════════════════════════════════╝